
NO sprites/mdoll.xpm
SO sprites/nschutz.xpm
WE sprites/ground.xpm
EA sprites/test4.xpm
F 190,190,190
C 152,245,255


        1111111111111111111111111
        1000000000110000000000001
        1011000001110000000000001
        1001000000000000000000001
111111111011000001110000000000001
100000000011000001110111101111111
11110111111111011100000010001
11110111111111011101210010001
11000000110101011100000010001111111111111111111111111111111111
10010000100000000000S00010002000000000000000000110000000000001
11111111111111121111111111111111111111011000001110000000000001
              101                    1001000000000000000000001
               1             111111111011000001110000000000001
                             100000000011000001110111111111111
                             11110111111111011100000000001      111        111
                             111101111111110111010100100011111111011111111110111
                                 11111111111111111111111000000000000011111110111
                                                       1111111111111001101010111
                                                                1000000000000011
                                                          111111101111111111111
                                                         101101010111      111
                                                         10000000001111111110111
                                                         11111111100111111110111
                                                                 110101101010111      111
                                                                  1010000000001111111110111
                                                                  1000111111100001111110111
                                      11111111111  111111111      11111      111001101010111
                              1111111110000000001111000100011111111111111111111100000000011
                             1100000011010101110000001000100000000000000000000000111111111
                             10000000000000001100000010001111111111111111111111111
                            110000000000000001101010010001
                           1000000001110101011111011110111
                          100111101111110001101110010001
11111111111111111111111111101111111111111211111111111111
10000000000000001100000010001           121
1000000000000000110101001000111         121
11000001110101011111011110111           121
111101111110101101111010001             121
111111111111111111111111101111111111111112111111111111111111
                        100000000000000000000110000000000001
                        1111111111110110000011100000000000011111     1111111111 11111111111111
                                   10010000000000000000000000001111111011000001110000000000001
                                   11111111111111111111111111100000000011000001110111111111111
                                                             11110111111111011100000010001
                                                             11110111111111011101010010001
                                                             11000000110101011100000010001
                                                             10000000000000001100000010001
                                                           1110000000000000000001010010001
                                                           1000000001110101011111011110111
                                                           1011110111111000110111101000111       1111111111111111111111111
                                                           101111111111110111111111111000111111111011000001110000000000001
                                                           101          111          1110000000000011000001110111111111111
                                                           101                         1111110111111111011100000010001
                                                           101                          111101111111110111010100100011
                                                           101                            11000000110101011100000010001
                                                           101                           10000000000000001100000010001
                                                           101                        11110000000000000001101010010001
                                                           101                        1000000001110101011111011110111
                                                         11101                        1110111101111110000001111010001
                                   111111111111111111111110001                          11111111111111111111111111111
                           11111111101100000111000000000000111
                           100000000011000001110111111111111
                           11110111111111011100000010001
                           11110111111111011101010010001
                           11000000110101011100000010001
                           10000000000000001100000010001
                           10000000000000000001010010001
                           11000001110101011111011110111
                           111101111110101101111010001
                           111101111111111111111111111
        1111111111111111111111101
        1000000000110000000000001
        1011000001110000000000001
        1001000000000000000000001
111111111011000001110000000000001
100000000011000001110111111111111
11110111111111011100000010001
11110111111111011101010010001
11000000110101011100000010001
10000000000000001100000010001
10000000000000001101010010001
11000001110101011111011110111
111101111110101101111010001
111111111111111111111111111
